11 24
@ @ @ @ @ @ @ @ @ @ @ @ @ @ @ @ @ @ @ @ @ @ @ @ 
@ . . @ @ @ @ . . . @ @ @ @ . . . @ @ @ @ . . @ 
@ . . . . . . . . . . . . . . . . . . . . . . @ 
@ . . @ @ @ @ . . . @ @ @ @ . . . @ @ @ @ . . @ 
@ . . . . . . . . . . . . . . . . . . . . . . @ 
@ . . @ @ @ @ . . . @ @ @ @ . . . @ @ @ @ . . @ 
@ . . . . . . . . . . . . . . . . . . . . . . @ 
@ . . @ @ @ @ . . . @ @ @ @ . . . @ @ @ @ . . @ 
@ . . . . . . . . . . . . . . . . . . . . . . @ 
@ . . @ @ @ @ . . . @ @ @ @ . . . @ @ @ @ . . @ 
@ @ @ @ @ @ @ @ @ @ @ @ @ @ @ @ @ @ @ @ @ @ @ @ 
7
1 1 9 22
1 22 9 1
2 1 8 22
2 22 8 1
3 1 7 22
3 22 7 1
4 1 6 22
