11 24
@ @ @ @ @ @ @ @ @ @ @ @ @ @ @ @ @ @ @ @ @ @ @ @ 
@ . . @ @ @ @ . . . @ @ @ @ . . . @ @ @ @ . . @ 
@ . . . . . . . @ . . . . . . @ . . . . . . . @ 
@ . . @ @ @ @ . . . @ @ @ @ . . . @ @ @ @ . . @ 
@ . . . . . . . @ . . . . . . @ . . . . . . . @ 
@ . . @ @ @ @ . . . @ @ @ @ . . . @ @ @ @ . . @ 
@ . . . . . . . @ . . . . . . @ . . . . . . . @ 
@ . . @ @ @ @ . . . @ @ @ @ . . . @ @ @ @ . . @ 
@ . . . . . . . @ . . . . . . @ . . . . . . . @ 
@ . . @ @ @ @ . . . @ @ @ @ . . . @ @ @ @ . . @ 
@ @ @ @ @ @ @ @ @ @ @ @ @ @ @ @ @ @ @ @ @ @ @ @ 
3
1 1 9 22
1 22 9 1
2 1 8 22
