11 24
@ @ @ @ @ @ @ @ @ @ @ @ @ @ @ @ @ @ @ @ @ @ @ @ 
@ . . @ @ @ @ . . . @ @ @ @ . . . @ @ @ @ . . @ 
@ . . . . . . . @ . . . . . . @ . . . . . . . @ 
@ . . @ @ @ @ . @ . @ @ @ @ . @ . @ @ @ @ . . @ 
@ . . . . . . . @ . . . . . . @ . . . . . . . @ 
@ . . @ @ @ @ . . . @ @ @ @ . . . @ @ @ @ . . @ 
@ . . . . . . . @ . . . . . . @ . . . . . . . @ 
@ . . @ @ @ @ . @ . @ @ @ @ . @ . @ @ @ @ . . @ 
@ . . . . . . . @ . . . . . . @ . . . . . . . @ 
@ . . @ @ @ @ . . . @ @ @ @ . . . @ @ @ @ . . @ 
@ @ @ @ @ @ @ @ @ @ @ @ @ @ @ @ @ @ @ @ @ @ @ @ 
5
1 1 9 22
1 22 9 1
2 1 8 22
2 22 8 1
3 1 7 22
