11 24
@ @ @ @ @ @ @ @ @ @ @ @ @ @ @ @ @ @ @ @ @ @ @ @ 
@ . . @ @ @ @ . . . @ @ @ @ . . . @ @ @ @ . . @ 
@ . . . . . . . @ . . . . . . @ . . . . . . . @ 
@ . . @ @ @ @ . . . @ @ @ @ . . . @ @ @ @ . . @ 
@ . . . . . . . @ . . . . . . @ . . . . . . . @ 
@ . . @ @ @ @ . . . @ @ @ @ . . . @ @ @ @ . . @ 
@ . . . . . . . @ . . . . . . @ . . . . . . . @ 
@ . . @ @ @ @ . . . @ @ @ @ . . . @ @ @ @ . . @ 
@ . . . . . . . @ . . . . . . @ . . . . . . . @ 
@ . . @ @ @ @ . . . @ @ @ @ . . . @ @ @ @ . . @ 
@ @ @ @ @ @ @ @ @ @ @ @ @ @ @ @ @ @ @ @ @ @ @ @ 
1
1 1 9 22
