11 24
@ @ @ @ @ @ @ @ @ @ @ @ @ @ @ @ @ @ @ @ @ @ @ @
@ . . @ @ @ @ . . . @ @ @ @ . . . @ @ @ @ . . @
@ . . . . . . . @ . . . . . . @ . . . . . . . @
@ . . @ @ @ @ . @ . @ @ @ @ . @ . @ @ @ @ . . @
@ . . . . . . . @ . . . . . . @ . . . . . . . @
@ . . @ @ @ @ . . . @ @ @ @ . . . @ @ @ @ . . @
@ . . . . . . . @ . . . . . . @ . . . . . . . @
@ . . @ @ @ @ . @ . @ @ @ @ . @ . @ @ @ @ . . @
@ . . . . . . . @ . . . . . . @ . . . . . . . @
@ . . @ @ @ @ . . . @ @ @ @ . . . @ @ @ @ . . @
@ @ @ @ @ @ @ @ @ @ @ @ @ @ @ @ @ @ @ @ @ @ @ @
9
1 1 5 22
2 1 6 22
3 1 7 22
4 1 8 22
5 1 9 22
1 22 9 1
2 22 8 1
3 22 7 1
4 22 6 1

