11 24
@ @ @ @ @ @ @ @ @ @ @ @ @ @ @ @ @ @ @ @ @ @ @ @
@ . . @ @ @ @ . . . @ @ @ @ . . . @ @ @ @ . . @
@ . . . . . . . @ . . . . . . @ . . . . . . . @
@ . . @ @ @ @ . . . @ @ @ @ . . . @ @ @ @ . . @
@ . . . . . . . @ . . . . . . @ . . . . . . . @
@ . . @ @ @ @ . . . @ @ @ @ . . . @ @ @ @ . . @
@ . . . . . . . @ . . . . . . @ . . . . . . . @
@ . . @ @ @ @ . . . @ @ @ @ . . . @ @ @ @ . . @
@ . . . . . . . @ . . . . . . @ . . . . . . . @
@ . . @ @ @ @ . . . @ @ @ @ . . . @ @ @ @ . . @
@ @ @ @ @ @ @ @ @ @ @ @ @ @ @ @ @ @ @ @ @ @ @ @
1
1 1 23 10
